cereal: ngũ cốc
leather: da thú
parsley: rau mùi tây
gravy: sauce
inevitably: không thể tránh khỏi
water retention: khả năng giữ nước
peak: đỉnh cao
dock: bến cảng
acids: a xít
bases: ba zơ
lie down: nằm xuống
tempest: cơn bão
urge: thúc dục
deceive: lừa dối
craft: nghề (job)
immunity: sự được miễn
criminal law: luật hình sự
sympathy: sự thông cảm
femininity: nữ tính
itch: sự ngứa
recite: đọc thuộc lòng
tremble: run rẩy
foolishly: một cách ngu ngốc
distinct difference: sự khác biệt rõ rệt
extravagant: hoang phí
cushion: cái đệm
decay: xuống cấp
preferably: tốt nhất là
peculiar: đặc biệt
expose: tiếp xúc
deed: hành động
weave wove woven: thêu dệt
reasonable: hợp lý
pace: nhịp độ
realm: vương quốc
allure: quyến rũ
wizard: phù thủy
amuse: làm vui
melancholy: u sầu
fern: dương xỉ
liquidity: tính thanh khoản
satellite: vệ tinh
chameleon: tắc kè hoa
evaporate: bay hơi
jug: cái bình
momentum: động lượng
entropy: độ hỗn loạn
dehydration: mất nước
heat stroke: say nắng
commodity: hàng hóa
agenda: chương trình nghị sự
legislative: lập pháp
cation: ion dương
potassium: kali
magnesium: magie
excuse: lí do, tha thứ
insurmountable: không thể vượt qua
naive: ngây thơ
overshadow: làm mờ
readily: dễ dàng
gigantic size: kích thước khổng lồ
alpine slope: dốc núi cao
digest: tiêu hóa
substantially: đáng kể
psychologically: về mặt tâm lý
tangible: cụ thể, hữu hình
falter: chùn bước, lung lay
textile fabric: vải
disgusted: ghê tởm
meticulously: tỉ mỉ
wield: điều khiển
acquisition: thu thập
stiff: cứng
underneath: bên dưới
vandalism: tội phá hoại
arrest: bắt giữ
morally: về mặt đạo đức
refinery: nhà máy lọc dầu
crude: thô
arduous: gian truân
steep: dốc
pelvic girdle: khung xương chậu
hind limbs: chi sau
vocational: nghề nghiệp
resourceful: tháo vát
oscillating: dao động
polarization: sự phân cực
delighted: vui mừng
downward: đi xuống
overstate: phóng đại
understate: nói giảm, nói tránh
unbearable: không thể chịu nổi
suspiciously: một cách nghi ngờ
interpretation: sự giải thích
encyclopedia: bách khoa toàn thư
nuanced: tinh tế
appellant: nguyên đơn
appeal: kháng cáo
citrus: cam, quít
centrifugal force: lực li tâm
mass: khối lượng
distillation: chưng cất
separate: tách, chia
deflect: làm lệch
meteorite: thiên thạch
assembly: sự lắp ráp
immobile: bất động
cacti: xương rồng
reside: cư trú
nucleus: hạt nhân
unceasingly: không ngừng
particle: hạt
sanitation: vệ sinh
denature: làm biến tính
restriction: sự hạn chế
devastated: bị tàn phá
gestation: mang thai
pilfer: ăn cắp
due diligence: việc thẩm định
tolerance: sức chịu đựng
arachnid: nhện
dizzy: chóng mặt
integral: cần thiết, không thể thiếu
silhouette: hình bóng
monsoon: gió mùa